
NO ./img/wall_no.xpm
SO ./img/wall_so.xpm

F 98,70,33
WE ./img/wall_we.xpm
EA ./img/wall_ea.xpm
C 77,159,240

111111111111111111111111111111
100000000000000010000000000001
111111100S00000010000000000001
100000000000000000000000000001
100000000000001111111111000001
100000000000001110000000000001
111000000000001110000000000001
100000000000000000000000000001
100000000000000000000000000001
100000000000010000000000000001
100000000000000000000000000001
100000000000000000000000000001
100000000000000000000000000001
100011111111111111111111110001
100000000000000000000000000001
100000000000000000000000000001
111111111111111111111111111111
111111111111111111111111111111
111111111111111111111111111111
