NO ./img/wall_no.xpm
SO ./img/wall_so.xpm
WE ./img/wall_we.xpm                        
EA ./img/wall_ea.xpm


F 210 ,100 , 3
C 225,30,1 

1111111111111111111111111
1000000000110000000000001
1011000001110000000000001
1001000000000000000000001
11111111101100000111000001
100000000011000001110111111111111
11110111111111011100000000001
1111011111111101110101E010001
11000000110101011100000010001
1111111111111111111111111111










