NO ./img/wall_no.xpm
SO ./img/wall_so.xpm
WE ./img/wall_we.xpm
EAasd ./img/wall_ea.xpm



F 210 ,100 ,1
C 225,30,1

1111111111111111111111111
1000000000110000000000001
1011000001110000000000001
1001000000000000000000001
111111111011000001110  000010000001
100000000011000001110111111111111
11110111111111011100000010001
1111011111111101110101N010001
11000000110101011100000010001
11111111111111111111111111111
10000000000000001101010000001
1100000111010101011101111000111
111101111110101101111010001
111111111111111111111111111
111111111111111
111111111111111