NO ./img/wall_no.xpm
SO ./img/wall_so.xpm
WE ./img/wall_we.xpm
EA ./img/wall_ea.xpm

F 98,70,33
C 77,159,240

1111111111111111111111111111111111
1000001000000E00000000000001001111
111010111111000111111111111
10001000000000000000000000011
101111111111110001111111111111111111111111111111111
100000000000000000000000000000000000000000000000001
1011111111111000011111101111111111111111111111111111
100000000000000000000001
1111111111111111111111111111111111
