
NO ./img/wall_no.xpm
SO ./img/wall_so.xpm
WE ./img/wall_we.xpm
EA ./img/wall_ea.xpm

Fa 10,10,1
C 10,10,10

1111111111111111111111111111111111
100000000000000000000001111
1000000000000001111111111
1000000000000000000000001111
100000000000000S000000000001
1000000000000000000000011101
11111111111111111111111111111111