
NO ./img/wall_no.xpm
SO ./img/wall_so.xpm
EA ./img/wall_ea.xpm
WE ./img/wall_we.xpm

C 255,100,160
F 122,122,122

N1111111111111111
10000000000000001
10000000000000001
10000000000000001
10000000000000001
10000000000000001
10001000000010001
10000000000000001
10000000000000001
10000000000000001
10000000000000001
10000000000000001
11111111111111111
